28
34
40
a222222222222222222b
6    1  9  1     m 4
6  1          m    4
61      1     m m  4
6   1     1  1  mm 4
6 1  m  m   1     14
6 mm m  mm 11 m m1 4
6                  4
6  mm    mm        4
6m  m  mm m  mm m3m4
6                  4
c888888888888888888d
%1:15:1-10
%3:18:1-10
%2:7:1-18
%2:10:1-18