29
35
50
a222222222222222222b
61  1   pm   1    l4
6 p    11  3 1 1  14
61         1 m  1  4
6    mm  p m  1    4
6 1   m 1         14
6        1 1 m     4
61    1  m     1 p 4
6   1 1     1      4
6 9    1           4
6      1 p  1   p  4
c888888888888888888d
!8-1:9-10
!2-2:16-10
!9-4:17-7
%1:10:1-10
%3:12:1-10