60
69
79
0a22222222222222222b
063   m      m 1   4
06    1          1 4
06 l           1 lm4
06mm  m1    mm   5 4
06  m m l  m       4
061m    mm7  1  11l4
06                 4
061m  l5   m m  9 14
06l 1       1  m   4
06    1            4
0c88888888888888888d
%0:7:2-18
%0:3:2-14
%1:14:1-10
%1:5:1-10