28
32
35
gga22222222222222bgg
ff61        1l  34ff
006   1       m  400
006       m      400
006      1   1   400
006         1  1 400
0e61  l       ml 400
i06              4ei
006  1    m      40e
006         m   9400
006l1            400
00c88888888888888d00
%2:7:3-16
%1:11:1-10
%1:15:1-10