18
22
24
gga22222222222222bgg
ff6   p         l4ff
0061     p       400
006 m            400
006             p400
006   m         1400
0e6 1 l  53      400
i06 5         7  4ei
006 9 1        m 40e
006              400
006  1l         p400
00c88888888888888d00
!6-1:16-10
!9-2:16-4
%0:9:3-16
%1:5:1-10