40
45
50
a222222222222222222b
6p    11   11 m p 14
6  9 1       p    14
6      1     1  1  4
6  m1  1  1 p 1  1m4
6             p3p  4
6     1  m 1    1  4
6    1  1   1 1    4
61           11  1 4
6   1    1    1  p 4
6      1    1   1 l4
c888888888888888888d
!16-1:12-4
!1-1:13-10
!16-5:14-5
!13-2:17-9
%2:5:1-18
%1:15:1-10