22
25
30
gga22222222222222bgg
ff61           p 4ff
006           pl 400
006 3 1     7 7  400
006      1  7m   400
006            1 400
0e6          m   400
i06             m4ei
0067    1    m   40e
0061        l l 1400
006p   1 p   l 9 400
00c88888888888888d00
!14-2:3-10
!15-1:9-10