27
28
30
a222222222222222222b
6   3 m      l     4
6                114
6    55            4
69 7m  m   l   p   4
6        m      p  4
6      m           4
6      m    m  1 p 4
6     1l           4
61l m         1l   4
6 7  7   p       mm4
c888888888888888888d
!15-4:9-10
!16-5:17-7
%1:6:4-7
%0:3:1-4
%1:5:1-2