14
16
21
a222222222222222222b
6          5       4
6   m        m     4
6                  4
6                  4
6     p       l1   4
6         3        4
6 1   m     1      4
6     7       1    4
6    l       9 m   4
6 m   7           p4
c888888888888888888d
!18-10:6-5
%1:3:1-10