30
32
39
a222222222222222222b
67      l     m    4
6ml m l         m  4
6 pl5       1     p4
6   p      lm      4
6           9    p 4
6                  4
6 1 m       p5p    4
6     m     l    3 4
6  m     5         4
6  7 5         l1  4
c888888888888888888d
%0:3:5-11
%1:13:1-6
!4-4:12-7
!14-7:17-5
!2-3:18-3
