24
28
30
a222222222222222222b
67          1  1p 54
6lm  5    9    1   4
67  m   m1      1  4
6         1     l1 4
6          1       4
6      1       1   4
6 l 1     1        4
6               1  4
6             13   4
6 p1         1lm   4
c888888888888888888d
!2-10:16-1