30
31
32
a222222222222222222b
6 5        7      m4
6  p  l5      1   14
6    1   l   m1  114
6      mmm    91p1p4
6            1  1  4
6          1    1 m4
6      1        1 l4
65                34
6     1      p     4
6  7    m      5   4
c888888888888888888d
!16-4:18-4
!3-2:13-9