30
34
37
a222222222222222222b
6 l        p      l4
6  1       m    1  4
6  11    l     11  4
6  911 m      11   4
6    1        1   m4
6     1            4
6 1            p   4
6            5     4
6        m      m1 4
637            1   4
c888888888888888888d
!11-1:15-7
%0:3:5-14