25
28
30
a222222222222222222b
6 1               l4
6  m   5l    3    m4
6                  4
61   7p 1m        m4
6    m  1 9 1 1 1  4
6 5      5         4
6            p    14
6         p     l1 4
6 p        1 l 1   4
6    lm  1         4
c888888888888888888d
!2-9:10-8
!13-7:6-4
%0:3:1-18
%1:7:3-10