34
37
38
11l   1l     1     1
                1 1 
  1        1     1  
     1         1    
                  1 
    1    1    1    3
 1      1   1     11
        1    1      
l  1  1    1 1   1  
1             1     
  1        1        
9   1  11l 1     1l 