19
21
25
gga22222222222222bgg
ff6 1       1    4ff
006          1   400
006   mml        400
006   9mml       400
006     mml      400
0e6      mml     400
i06           1  4ei
006           37140e
006       1      400
006  1         1 400
00c88888888888888d00