6
8
12
a222222222222222222b
6        5         4
6                  4
6         1   3    4
6   5              4
6           1      4
6              5   4
6       1 9        4
6    1          1  4
61                 4
6          1       4
c888888888888888888d