12
15
20
a222222222222222222b
61     1      1 1 34
61  1    1        14
61        11       4
6     1     1    1 4
6        9   1 1   4
6            1  1  4
6           1    1 4
6 1             1  4
61         1       4
6        1        14
c888888888888888888d