7
9
11
00000000000000000000
00000000000000000000
000a222222222222b000
0006         1  4000
0006      5     4000
00069   l5l    34000
0006            4000
0006     1      4000
000c888888888888d000
00000000000000000000
00000000000000000000
00000000000000000000