19
22
25
a222222222222222222b
69               1 4
61      1         14
6                  4
6        1  1      4
6      1   1   1   4
6    1       1     4
6         1    1   4
6   1      1    1 14
6 1         1  1 1 4
6          1 1    34
c888888888888888888d